2048x
48444844444444484444
44448444444444444444
44444444444444444484
44444448444444444444
44444844444444844444
44448444844844444444
44444444444444444444
44444844444448444844
44444484444444448844
44444448444444444444
44444444444444488444
44444444488484444444
48444844444444448444
44444444444444448444
84444444444444444444
44444444444448844444
44444444444444444444
44844444444844444444
44444444448848444844
44444444444844484444
